token,경주빈도,전주빈도,빈도합,경주비율,전주비율
코스,484,489,973,49.74%,50.26%
추천,401,350,751,53.40%,46.60%
맛집,65,271,336,19.35%,80.65%
여수,0,319,319,0.00%,100.00%
주달,0,278,278,0.00%,100.00%
숙소,178,76,254,70.08%,29.92%
질문,133,95,228,58.33%,41.67%
한옥마을,0,195,195,0.00%,100.00%
부탁,115,79,194,59.28%,40.72%
답변,123,65,188,65.43%,34.57%
일정,99,80,179,55.31%,44.69%
계획,137,35,172,79.65%,20.35%
티비,0,162,162,0.00%,100.00%
국내,5,142,147,3.40%,96.60%
친구,50,95,145,34.48%,65.52%
제주,0,137,137,0.00%,100.00%
제주도,15,116,131,11.45%,88.55%
전문,5,116,121,4.13%,95.87%
언서,0,121,121,0.00%,100.00%
봉이,0,121,121,0.00%,100.00%
관련,86,35,121,71.07%,28.93%
가족,101,15,116,87.07%,12.93%
안녕,69,45,114,60.53%,39.47%
한옥,0,111,111,0.00%,100.00%
마을,0,91,91,0.00%,100.00%
참고,50,40,90,55.56%,44.44%
정도,51,37,88,57.95%,42.05%
택시,55,30,85,64.71%,35.29%
이번,30,55,85,35.29%,64.71%
공원,27,53,80,33.75%,66.25%
준비,39,40,79,49.37%,50.63%
시간,27,50,77,35.06%,64.94%
당일치기,25,50,75,33.33%,66.67%
황리,72,0,72,100.00%,0.00%
장소,46,25,71,64.79%,35.21%
이용,35,30,65,53.85%,46.15%
관광지,35,30,65,53.85%,46.15%
가능,20,40,60,33.33%,66.67%
예정,20,40,60,33.33%,66.67%
아이,35,25,60,58.33%,41.67%
호텔,15,42,57,26.32%,73.68%
숙박,35,20,55,63.64%,36.36%
펜션,35,20,55,63.64%,36.36%
여자,30,25,55,54.55%,45.45%
역사,44,10,54,81.48%,18.52%
불국사,53,0,53,100.00%,0.00%
거리,15,38,53,28.30%,71.70%
근처,20,33,53,37.74%,62.26%
사람,10,43,53,18.87%,81.13%
갈만,21,30,51,41.18%,58.82%
이동,20,30,50,40.00%,60.00%
엄마,50,0,50,100.00%,0.00%
남자,10,40,50,20.00%,80.00%
동선,45,5,50,90.00%,10.00%
아래,29,20,49,59.18%,40.82%
덕진,0,48,48,0.00%,100.00%
시장,20,28,48,41.67%,58.33%
추억,37,10,47,78.72%,21.28%
동궁,45,0,45,100.00%,0.00%
도착,30,15,45,66.67%,33.33%
가요,35,10,45,77.78%,22.22%
첨성대,43,0,43,100.00%,0.00%
감사,5,38,43,11.63%,88.37%
도움,20,23,43,46.51%,53.49%
처음,25,18,43,58.14%,41.86%
시작,10,31,41,24.39%,75.61%
혼자,10,30,40,25.00%,75.00%
비용,0,40,40,0.00%,100.00%
동물원,0,40,40,0.00%,100.00%
문화,20,20,40,50.00%,50.00%
아빠,35,5,40,87.50%,12.50%
투어,29,10,39,74.36%,25.64%
식당,35,4,39,89.74%,10.26%
버스,13,25,38,34.21%,65.79%
대중교통,20,17,37,54.05%,45.95%
얼마,4,32,36,11.11%,88.89%
관광,6,30,36,16.67%,83.33%
터미널,10,25,35,28.57%,71.43%
방문,25,10,35,71.43%,28.57%
월지,35,0,35,100.00%,0.00%
주말,15,20,35,42.86%,57.14%
체험,6,29,35,17.14%,82.86%
하루,30,5,35,85.71%,14.29%
빌라,35,0,35,100.00%,0.00%
날씨,35,0,35,100.00%,0.00%
도보,24,10,34,70.59%,29.41%
생각,19,15,34,55.88%,44.12%
부모,19,15,34,55.88%,44.12%
가격,5,27,32,15.62%,84.38%
카페,15,17,32,46.88%,53.12%
아들,32,0,32,100.00%,0.00%
렌트,10,20,30,33.33%,66.67%
시내,30,0,30,100.00%,0.00%
수목원,0,30,30,0.00%,100.00%
다음,15,15,30,50.00%,50.00%
전라도,0,30,30,0.00%,100.00%
당일,10,20,30,33.33%,66.67%
한복,10,19,29,34.48%,65.52%
위치,23,5,28,82.14%,17.86%
보문,28,0,28,100.00%,0.00%
석굴암,26,0,26,100.00%,0.00%
강아지,0,25,25,0.00%,100.00%
음식,0,25,25,0.00%,100.00%
루트,25,0,25,100.00%,0.00%
부산,20,5,25,80.00%,20.00%
소개,25,0,25,100.00%,0.00%
위주,15,10,25,60.00%,40.00%
정보,5,20,25,20.00%,80.00%
첨부,20,5,25,80.00%,20.00%
확인,20,5,25,80.00%,20.00%
제외,5,20,25,20.00%,80.00%
초등,10,15,25,40.00%,60.00%
포항,25,0,25,100.00%,0.00%
학년,15,10,25,60.00%,40.00%
지도,25,0,25,100.00%,0.00%
필요,10,15,25,40.00%,60.00%
추석,8,15,23,34.78%,65.22%
남부,0,23,23,0.00%,100.00%
사진,13,10,23,56.52%,43.48%
구경,5,18,23,21.74%,78.26%
경비,3,20,23,13.04%,86.96%
박물관,7,15,22,31.82%,68.18%
월드,22,0,22,100.00%,0.00%
고등학생,17,5,22,77.27%,22.73%
예약,10,10,20,50.00%,50.00%
말씀,10,10,20,50.00%,50.00%
대부분,5,15,20,25.00%,75.00%
경기전,0,20,20,0.00%,100.00%
숙박비,0,20,20,0.00%,100.00%
향교,0,20,20,0.00%,100.00%
포함,5,15,20,25.00%,75.00%
명소,5,15,20,25.00%,75.00%
야경,15,5,20,75.00%,25.00%
채택,15,5,20,75.00%,25.00%
중요,20,0,20,100.00%,0.00%
공항,20,0,20,100.00%,0.00%
평일,15,5,20,75.00%,25.00%
편안,15,5,20,75.00%,25.00%
실패,20,0,20,100.00%,0.00%
남산,15,5,20,75.00%,25.00%
주요,20,0,20,100.00%,0.00%
어머니,15,5,20,75.00%,25.00%
도시,9,10,19,47.37%,52.63%
서울,9,10,19,47.37%,52.63%
오전,9,10,19,47.37%,52.63%
선택,14,5,19,73.68%,26.32%
교통비,3,15,18,16.67%,83.33%
남친,10,8,18,55.56%,44.44%
커플,10,8,18,55.56%,44.44%
국립,7,10,17,41.18%,58.82%
내공,10,7,17,58.82%,41.18%
시절,12,5,17,70.59%,29.41%
지역,6,10,16,37.50%,62.50%
일차,11,5,16,68.75%,31.25%
렌트카,10,6,16,62.50%,37.50%
인근,10,5,15,66.67%,33.33%
천마총,15,0,15,100.00%,0.00%
전통,0,15,15,0.00%,100.00%
중앙,15,0,15,100.00%,0.00%
토요일,5,10,15,33.33%,66.67%
단지,15,0,15,100.00%,0.00%
하우스,5,10,15,33.33%,66.67%
광주,0,15,15,0.00%,100.00%
벽화,0,15,15,0.00%,100.00%
전동성당,0,15,15,0.00%,100.00%
대릉원,15,0,15,100.00%,0.00%
게스트,5,10,15,33.33%,66.67%
운전,15,0,15,100.00%,0.00%
볼거리,0,15,15,0.00%,100.00%
오푸스,15,0,15,100.00%,0.00%
마음,15,0,15,100.00%,0.00%
산책,0,15,15,0.00%,100.00%
여성,15,0,15,100.00%,0.00%
맞춤,10,5,15,66.67%,33.33%
자동차,0,15,15,0.00%,100.00%
문제,10,5,15,66.67%,33.33%
의견,10,5,15,66.67%,33.33%
학생,10,5,15,66.67%,33.33%
남편,15,0,15,100.00%,0.00%
황성,15,0,15,100.00%,0.00%
검색,10,5,15,66.67%,33.33%
가을,10,5,15,66.67%,33.33%
자차,5,10,15,33.33%,66.67%
조언,10,5,15,66.67%,33.33%
기본,5,10,15,33.33%,66.67%
예상,5,10,15,33.33%,66.67%
기차표,10,5,15,66.67%,33.33%
중순,10,5,15,66.67%,33.33%
빵집,15,0,15,100.00%,0.00%
할머니,15,0,15,100.00%,0.00%
바다,5,10,15,33.33%,66.67%
고민,15,0,15,100.00%,0.00%
고등학교,0,15,15,0.00%,100.00%
쿠지,15,0,15,100.00%,0.00%
실내,10,5,15,66.67%,33.33%
쭈니,10,5,15,66.67%,33.33%
출발,9,5,14,64.29%,35.71%
주변,5,7,12,41.67%,58.33%
엑스포,12,0,12,100.00%,0.00%
저녁,7,5,12,58.33%,41.67%
추가,0,12,12,0.00%,100.00%
유적지,6,5,11,54.55%,45.45%
교통,0,11,11,0.00%,100.00%
경우,11,0,11,100.00%,0.00%
이상,0,10,10,0.00%,100.00%
자연,5,5,10,50.00%,50.00%
체크인,5,5,10,50.00%,50.00%
중간,5,5,10,50.00%,50.00%
비빔,0,10,10,0.00%,100.00%
복귀,0,10,10,0.00%,100.00%
보통,0,10,10,0.00%,100.00%
제시,5,5,10,50.00%,50.00%
랜드,0,10,10,0.00%,100.00%
작성,5,5,10,50.00%,50.00%
라면,0,10,10,0.00%,100.00%
동반,0,10,10,0.00%,100.00%
난장,0,10,10,0.00%,100.00%
금요일,0,10,10,0.00%,100.00%
취향,5,5,10,50.00%,50.00%
여행지,5,5,10,50.00%,50.00%
아침,5,5,10,50.00%,50.00%
시설,5,5,10,50.00%,50.00%
시대,5,5,10,50.00%,50.00%
생활,5,5,10,50.00%,50.00%
사이트,5,5,10,50.00%,50.00%
블로그,5,5,10,50.00%,50.00%
블로거,5,5,10,50.00%,50.00%
부부,5,5,10,50.00%,50.00%
방학,5,5,10,50.00%,50.00%
그때,0,10,10,0.00%,100.00%
문자,5,5,10,50.00%,50.00%
사투리,0,10,10,0.00%,100.00%
친정,5,5,10,50.00%,50.00%
일인,0,10,10,0.00%,100.00%
카테고리,5,5,10,50.00%,50.00%
자가용,0,10,10,0.00%,100.00%
자만,0,10,10,0.00%,100.00%
요소,0,10,10,0.00%,100.00%
전시회,0,10,10,0.00%,100.00%
완주,0,10,10,0.00%,100.00%
점심,0,10,10,0.00%,100.00%
영화제,0,10,10,0.00%,100.00%
정리,0,10,10,0.00%,100.00%
연령,0,10,10,0.00%,100.00%
주주,0,10,10,0.00%,100.00%
지난주,0,10,10,0.00%,100.00%
진주,0,10,10,0.00%,100.00%
진행,0,10,10,0.00%,100.00%
초코파이,0,10,10,0.00%,100.00%
최고봉,0,10,10,0.00%,100.00%
수원,0,10,10,0.00%,100.00%
크리스마스,0,10,10,0.00%,100.00%
타워,0,10,10,0.00%,100.00%
한국도로공사,0,10,10,0.00%,100.00%
호수,0,10,10,0.00%,100.00%
학교,5,5,10,50.00%,50.00%
수단,0,10,10,0.00%,100.00%
소리,0,10,10,0.00%,100.00%
편리,5,5,10,50.00%,50.00%
생략,0,10,10,0.00%,100.00%
탐방,5,5,10,50.00%,50.00%
코로나,5,5,10,50.00%,50.00%
먹거리,5,5,10,50.00%,50.00%
무리,0,10,10,0.00%,100.00%
반려,0,10,10,0.00%,100.00%
특별,10,0,10,100.00%,0.00%
일간,10,0,10,100.00%,0.00%
저번,10,0,10,100.00%,0.00%
절리,10,0,10,100.00%,0.00%
정복,10,0,10,100.00%,0.00%
주상,10,0,10,100.00%,0.00%
주신,10,0,10,100.00%,0.00%
주제,10,0,10,100.00%,0.00%
주차,10,0,10,100.00%,0.00%
초등학생,10,0,10,100.00%,0.00%
캐리,10,0,10,100.00%,0.00%
캐리어,10,0,10,100.00%,0.00%
파크,10,0,10,100.00%,0.00%
월말,10,0,10,100.00%,0.00%
패딩,10,0,10,100.00%,0.00%
황남,10,0,10,100.00%,0.00%
황동,10,0,10,100.00%,0.00%
황지,10,0,10,100.00%,0.00%
가실,5,5,10,50.00%,50.00%
기념,5,5,10,50.00%,50.00%
기간,5,5,10,50.00%,50.00%
고려,5,5,10,50.00%,50.00%
관람,5,5,10,50.00%,50.00%
계절,5,5,10,50.00%,50.00%
경치,5,5,10,50.00%,50.00%
인원,10,0,10,100.00%,0.00%
책자,10,0,10,100.00%,0.00%
요번,10,0,10,100.00%,0.00%
문화재,10,0,10,100.00%,0.00%
경북,10,0,10,100.00%,0.00%
경주로,10,0,10,100.00%,0.00%
구성원,10,0,10,100.00%,0.00%
기상,10,0,10,100.00%,0.00%
기차,10,0,10,100.00%,0.00%
나용,10,0,10,100.00%,0.00%
요금,10,0,10,100.00%,0.00%
느낌,10,0,10,100.00%,0.00%
다면,10,0,10,100.00%,0.00%
달동네,10,0,10,100.00%,0.00%
대접,10,0,10,100.00%,0.00%
경험,5,5,10,50.00%,50.00%
미술관,10,0,10,100.00%,0.00%
시기,10,0,10,100.00%,0.00%
예보,10,0,10,100.00%,0.00%
예매,10,0,10,100.00%,0.00%
어사이즈,10,0,10,100.00%,0.00%
어르신,10,0,10,100.00%,0.00%
대여,5,5,10,50.00%,50.00%
애인,10,0,10,100.00%,0.00%
양남,10,0,10,100.00%,0.00%
버드,10,0,10,100.00%,0.00%
사월,10,0,10,100.00%,0.00%
이틀,5,4,9,55.56%,44.44%
동안,5,4,9,55.56%,44.44%
한국,4,5,9,44.44%,55.56%
여유,8,0,8,100.00%,0.00%
바닷가,0,8,8,0.00%,100.00%
월요일,3,5,8,37.50%,62.50%
배달,8,0,8,100.00%,0.00%
입장료,3,5,8,37.50%,62.50%
식사,7,0,7,100.00%,0.00%
음식점,0,7,7,0.00%,100.00%
목대,0,7,7,0.00%,100.00%
조절,7,0,7,100.00%,0.00%
순서,0,6,6,0.00%,100.00%
공장,0,5,5,0.00%,100.00%
켈로그,0,5,5,0.00%,100.00%
공방,0,5,5,0.00%,100.00%
공연,0,5,5,0.00%,100.00%
고궁,0,5,5,0.00%,100.00%
경로,0,5,5,0.00%,100.00%
태교,0,5,5,0.00%,100.00%
골목,0,5,5,0.00%,100.00%
전주시,0,5,5,0.00%,100.00%
케이블카,0,5,5,0.00%,100.00%
교동,0,5,5,0.00%,100.00%
토종,0,5,5,0.00%,100.00%
날짜,0,5,5,0.00%,100.00%
김선용,0,5,5,0.00%,100.00%
길손,0,5,5,0.00%,100.00%
체증,0,5,5,0.00%,100.00%
기회,0,5,5,0.00%,100.00%
기지,0,5,5,0.00%,100.00%
기관,0,5,5,0.00%,100.00%
금액,0,5,5,0.00%,100.00%
그램,0,5,5,0.00%,100.00%
군산,0,5,5,0.00%,100.00%
구용,0,5,5,0.00%,100.00%
취사,0,5,5,0.00%,100.00%
침대,0,5,5,0.00%,100.00%
교육,0,5,5,0.00%,100.00%
건물,0,5,5,0.00%,100.00%
현대,0,5,5,0.00%,100.00%
걱정,0,5,5,0.00%,100.00%
피큐어,0,5,5,0.00%,100.00%
휴무,0,5,5,0.00%,100.00%
휴가,0,5,5,0.00%,100.00%
후반,0,5,5,0.00%,100.00%
회관,0,5,5,0.00%,100.00%
현황,0,5,5,0.00%,100.00%
현재,0,5,5,0.00%,100.00%
내용,0,5,5,0.00%,100.00%
허락,0,5,5,0.00%,100.00%
항목,0,5,5,0.00%,100.00%
한정식,0,5,5,0.00%,100.00%
하트,0,5,5,0.00%,100.00%
하늘,0,5,5,0.00%,100.00%
플랫,0,5,5,0.00%,100.00%
거북,0,5,5,0.00%,100.00%
평점,0,5,5,0.00%,100.00%
팔복,0,5,5,0.00%,100.00%
팀조,0,5,5,0.00%,100.00%
가보세요,0,5,5,0.00%,100.00%
가본,0,5,5,0.00%,100.00%
가운데,0,5,5,0.00%,100.00%
강추,0,5,5,0.00%,100.00%
트레,0,5,5,0.00%,100.00%
개인,0,5,5,0.00%,100.00%
객리,0,5,5,0.00%,100.00%
통상,0,5,5,0.00%,100.00%
갤러리,0,5,5,0.00%,100.00%
내부,0,5,5,0.00%,100.00%
다랭이,0,5,5,0.00%,100.00%
내일,0,5,5,0.00%,100.00%
억양,0,5,5,0.00%,100.00%
조정,0,5,5,0.00%,100.00%
오픈,0,5,5,0.00%,100.00%
오랜만,0,5,5,0.00%,100.00%
주년,0,5,5,0.00%,100.00%
예술,0,5,5,0.00%,100.00%
영화,0,5,5,0.00%,100.00%
주만,0,5,5,0.00%,100.00%
연인,0,5,5,0.00%,100.00%
연못,0,5,5,0.00%,100.00%
연극,0,5,5,0.00%,100.00%
여행객,0,5,5,0.00%,100.00%
에도,0,5,5,0.00%,100.00%
주문,0,5,5,0.00%,100.00%
노니,0,5,5,0.00%,100.00%
양식,0,5,5,0.00%,100.00%
애견,0,5,5,0.00%,100.00%
알짜배기,0,5,5,0.00%,100.00%
안쪽,0,5,5,0.00%,100.00%
안내,0,5,5,0.00%,100.00%
실시간,0,5,5,0.00%,100.00%
스타,0,5,5,0.00%,100.00%
스로,0,5,5,0.00%,100.00%
슈퍼,0,5,5,0.00%,100.00%
주박,0,5,5,0.00%,100.00%
수학,0,5,5,0.00%,100.00%
수정,0,5,5,0.00%,100.00%
조식,0,5,5,0.00%,100.00%
오후,0,5,5,0.00%,100.00%
조선,0,5,5,0.00%,100.00%
완산구,0,5,5,0.00%,100.00%
전주국,0,5,5,0.00%,100.00%
전일,0,5,5,0.00%,100.00%
전망,0,5,5,0.00%,100.00%
전라북도,0,5,5,0.00%,100.00%
전라,0,5,5,0.00%,100.00%
자체,0,5,5,0.00%,100.00%
일식,0,5,5,0.00%,100.00%
전주식,0,5,5,0.00%,100.00%
일반,0,5,5,0.00%,100.00%
인당,0,5,5,0.00%,100.00%
전통문화,0,5,5,0.00%,100.00%
이외,0,5,5,0.00%,100.00%
이벤트,0,5,5,0.00%,100.00%
이동은,0,5,5,0.00%,100.00%
의외,0,5,5,0.00%,100.00%
정감,0,5,5,0.00%,100.00%
웨이팅,0,5,5,0.00%,100.00%
운송,0,5,5,0.00%,100.00%
우유,0,5,5,0.00%,100.00%
욕조,0,5,5,0.00%,100.00%
조건,0,5,5,0.00%,100.00%
요청,0,5,5,0.00%,100.00%
요일,0,5,5,0.00%,100.00%
요약,0,5,5,0.00%,100.00%
왕복,0,5,5,0.00%,100.00%
수구,0,5,5,0.00%,100.00%
소유,0,5,5,0.00%,100.00%
소요,0,5,5,0.00%,100.00%
리의,0,5,5,0.00%,100.00%
려인,0,5,5,0.00%,100.00%
동물,0,5,5,0.00%,100.00%
주이,0,5,5,0.00%,100.00%
중식,0,5,5,0.00%,100.00%
독일,0,5,5,0.00%,100.00%
도로공사,0,5,5,0.00%,100.00%
데이트,0,5,5,0.00%,100.00%
중심,0,5,5,0.00%,100.00%
지밀,0,5,5,0.00%,100.00%
더클래식,0,5,5,0.00%,100.00%
대학,0,5,5,0.00%,100.00%
대표,0,5,5,0.00%,100.00%
지방,0,5,5,0.00%,100.00%
대옥,0,5,5,0.00%,100.00%
지식,0,5,5,0.00%,100.00%
대둔산,0,5,5,0.00%,100.00%
당장,0,5,5,0.00%,100.00%
답장,0,5,5,0.00%,100.00%
닭볶음탕,0,5,5,0.00%,100.00%
차량,0,5,5,0.00%,100.00%
달인,0,5,5,0.00%,100.00%
단점,0,5,5,0.00%,100.00%
천차만별,0,5,5,0.00%,100.00%
다윈,0,5,5,0.00%,100.00%
전주비빔밥,0,5,5,0.00%,100.00%
롯데,0,5,5,0.00%,100.00%
막걸리,0,5,5,0.00%,100.00%
소속,0,5,5,0.00%,100.00%
명품,0,5,5,0.00%,100.00%
세염,0,5,5,0.00%,100.00%
성미,0,5,5,0.00%,100.00%
서신동,0,5,5,0.00%,100.00%
생일,0,5,5,0.00%,100.00%
새만금,0,5,5,0.00%,100.00%
주세,0,5,5,0.00%,100.00%
상담,0,5,5,0.00%,100.00%
사회,0,5,5,0.00%,100.00%
주식,0,5,5,0.00%,100.00%
사용,0,5,5,0.00%,100.00%
불편,0,5,5,0.00%,100.00%
분위기,0,5,5,0.00%,100.00%
북대,0,5,5,0.00%,100.00%
부분,0,5,5,0.00%,100.00%
부담,0,5,5,0.00%,100.00%
본점,0,5,5,0.00%,100.00%
보리암,0,5,5,0.00%,100.00%
별루,0,5,5,0.00%,100.00%
변호사,0,5,5,0.00%,100.00%
변호,0,5,5,0.00%,100.00%
법률,0,5,5,0.00%,100.00%
반양,0,5,5,0.00%,100.00%
물관,0,5,5,0.00%,100.00%
문의,0,5,5,0.00%,100.00%
모주,0,5,5,0.00%,100.00%
주목적,0,5,5,0.00%,100.00%
작년,5,0,5,100.00%,0.00%
언니,5,0,5,100.00%,0.00%
바람,5,0,5,100.00%,0.00%
비추,5,0,5,100.00%,0.00%
분류,5,0,5,100.00%,0.00%
봄바람,5,0,5,100.00%,0.00%
보문관광단지,5,0,5,100.00%,0.00%
베어,5,0,5,100.00%,0.00%
벚꽃,5,0,5,100.00%,0.00%
번국,5,0,5,100.00%,0.00%
방법,5,0,5,100.00%,0.00%
바탕,5,0,5,100.00%,0.00%
바베큐,5,0,5,100.00%,0.00%
바니,5,0,5,100.00%,0.00%
사전,5,0,5,100.00%,0.00%
미성년자,5,0,5,100.00%,0.00%
뮤지엄,5,0,5,100.00%,0.00%
모텔,5,0,5,100.00%,0.00%
명과,5,0,5,100.00%,0.00%
며칠,5,0,5,100.00%,0.00%
매일,5,0,5,100.00%,0.00%
마지막,5,0,5,100.00%,0.00%
리조트,5,0,5,100.00%,0.00%
루지,5,0,5,100.00%,0.00%
렌터카,5,0,5,100.00%,0.00%
비피,5,0,5,100.00%,0.00%
생물학,5,0,5,100.00%,0.00%
동네,5,0,5,100.00%,0.00%
실제,5,0,5,100.00%,0.00%
여동생,5,0,5,100.00%,0.00%
에서,5,0,5,100.00%,0.00%
언덕,5,0,5,100.00%,0.00%
어머님,5,0,5,100.00%,0.00%
어린애,5,0,5,100.00%,0.00%
어른,5,0,5,100.00%,0.00%
어려움,5,0,5,100.00%,0.00%
안내소,5,0,5,100.00%,0.00%
아버지,5,0,5,100.00%,0.00%
실행,5,0,5,100.00%,0.00%
신축,5,0,5,100.00%,0.00%
선배,5,0,5,100.00%,0.00%
신상,5,0,5,100.00%,0.00%
신라,5,0,5,100.00%,0.00%
신경주역,5,0,5,100.00%,0.00%
식물원,5,0,5,100.00%,0.00%
시즌,5,0,5,100.00%,0.00%
스테이,5,0,5,100.00%,0.00%
술집,5,0,5,100.00%,0.00%
수학여행,5,0,5,100.00%,0.00%
수면,5,0,5,100.00%,0.00%
솔거,5,0,5,100.00%,0.00%
랜드마크,5,0,5,100.00%,0.00%
동굴,5,0,5,100.00%,0.00%
역하,5,0,5,100.00%,0.00%
결혼기념일,5,0,5,100.00%,0.00%
공부,5,0,5,100.00%,0.00%
공개,5,0,5,100.00%,0.00%
고택,5,0,5,100.00%,0.00%
고요,5,0,5,100.00%,0.00%
고속버스,5,0,5,100.00%,0.00%
경험담,5,0,5,100.00%,0.00%
경주역,5,0,5,100.00%,0.00%
경량,5,0,5,100.00%,0.00%
경기도,5,0,5,100.00%,0.00%
경경,5,0,5,100.00%,0.00%
결과,5,0,5,100.00%,0.00%
교복,5,0,5,100.00%,0.00%
겨울,5,0,5,100.00%,0.00%
객실,5,0,5,100.00%,0.00%
개화,5,0,5,100.00%,0.00%
개별,5,0,5,100.00%,0.00%
감성,5,0,5,100.00%,0.00%
감상,5,0,5,100.00%,0.00%
가여,5,0,5,100.00%,0.00%
가시,5,0,5,100.00%,0.00%
가본적,5,0,5,100.00%,0.00%
가려,5,0,5,100.00%,0.00%
관심,5,0,5,100.00%,0.00%
교통편,5,0,5,100.00%,0.00%
독채,5,0,5,100.00%,0.00%
나이,5,0,5,100.00%,0.00%
도보이,5,0,5,100.00%,0.00%
도변,5,0,5,100.00%,0.00%
대상,5,0,5,100.00%,0.00%
대구,5,0,5,100.00%,0.00%
대공원,5,0,5,100.00%,0.00%
다양,5,0,5,100.00%,0.00%
뉴스,5,0,5,100.00%,0.00%
네이버,5,0,5,100.00%,0.00%
내년,5,0,5,100.00%,0.00%
낭비,5,0,5,100.00%,0.00%
나드리,5,0,5,100.00%,0.00%
구매,5,0,5,100.00%,0.00%
기준,5,0,5,100.00%,0.00%
기온,5,0,5,100.00%,0.00%
기상청,5,0,5,100.00%,0.00%
기반,5,0,5,100.00%,0.00%
그동안,5,0,5,100.00%,0.00%
권역,5,0,5,100.00%,0.00%
궁터,5,0,5,100.00%,0.00%
군요,5,0,5,100.00%,0.00%
구체,5,0,5,100.00%,0.00%
구스,5,0,5,100.00%,0.00%
여름,5,0,5,100.00%,0.00%
여권,5,0,5,100.00%,0.00%
열차,5,0,5,100.00%,0.00%
최대한,5,0,5,100.00%,0.00%
카트라이더,5,0,5,100.00%,0.00%
카카오,5,0,5,100.00%,0.00%
예전,5,0,5,100.00%,0.00%
추도,5,0,5,100.00%,0.00%
최초,5,0,5,100.00%,0.00%
최적,5,0,5,100.00%,0.00%
최소한,5,0,5,100.00%,0.00%
최근,5,0,5,100.00%,0.00%
중학,5,0,5,100.00%,0.00%
초보,5,0,5,100.00%,0.00%
청소년,5,0,5,100.00%,0.00%
청공,5,0,5,100.00%,0.00%
첫날,5,0,5,100.00%,0.00%
천군동,5,0,5,100.00%,0.00%
지인,5,0,5,100.00%,0.00%
지리,5,0,5,100.00%,0.00%
코레,5,0,5,100.00%,0.00%
코트,5,0,5,100.00%,0.00%
퀄리티,5,0,5,100.00%,0.00%
테마파크,5,0,5,100.00%,0.00%
힐링,5,0,5,100.00%,0.00%
회수,5,0,5,100.00%,0.00%
활용,5,0,5,100.00%,0.00%
활동,5,0,5,100.00%,0.00%
환절기,5,0,5,100.00%,0.00%
행복,5,0,5,100.00%,0.00%
해결책,5,0,5,100.00%,0.00%
한화,5,0,5,100.00%,0.00%
플레이스,5,0,5,100.00%,0.00%
폴라로이드,5,0,5,100.00%,0.00%
포토,5,0,5,100.00%,0.00%
포스팅,5,0,5,100.00%,0.00%
평지,5,0,5,100.00%,0.00%
토함산,5,0,5,100.00%,0.00%
테이,5,0,5,100.00%,0.00%
중학교,5,0,5,100.00%,0.00%
카메라,5,0,5,100.00%,0.00%
중반,5,0,5,100.00%,0.00%
이튿날,5,0,5,100.00%,0.00%
이름,5,0,5,100.00%,0.00%
의미,5,0,5,100.00%,0.00%
유산,5,0,5,100.00%,0.00%
월드컵,5,0,5,100.00%,0.00%
원릉,5,0,5,100.00%,0.00%
움직임,5,0,5,100.00%,0.00%
울산,5,0,5,100.00%,0.00%
운영,5,0,5,100.00%,0.00%
우양,5,0,5,100.00%,0.00%
용시,5,0,5,100.00%,0.00%
요즘,5,0,5,100.00%,0.00%
왕자,5,0,5,100.00%,0.00%
옵션,5,0,5,100.00%,0.00%
옥스,5,0,5,100.00%,0.00%
주후,5,0,5,100.00%,0.00%
이맘때,5,0,5,100.00%,0.00%
오랫동안,5,0,5,100.00%,0.00%
이후,5,0,5,100.00%,0.00%
정신,5,0,5,100.00%,0.00%
주역,5,0,5,100.00%,0.00%
조화,5,0,5,100.00%,0.00%
조사,5,0,5,100.00%,0.00%
조금,5,0,5,100.00%,0.00%
제안,5,0,5,100.00%,0.00%
제가,5,0,5,100.00%,0.00%
제한,5,0,5,100.00%,0.00%
정성,5,0,5,100.00%,0.00%
전남,5,0,5,100.00%,0.00%
재미,5,0,5,100.00%,0.00%
작품,5,0,5,100.00%,0.00%
입실,5,0,5,100.00%,0.00%
인테리어,5,0,5,100.00%,0.00%
인치,5,0,5,100.00%,0.00%
출발지,4,0,4,100.00%,0.00%
주가,0,4,4,0.00%,100.00%
인천,0,4,4,0.00%,100.00%
길거리,0,4,4,0.00%,100.00%
광고,0,4,4,0.00%,100.00%
형편,4,0,4,100.00%,0.00%
해몽,4,0,4,100.00%,0.00%
컴퓨터,4,0,4,100.00%,0.00%
조립식,4,0,4,100.00%,0.00%
시내버스,4,0,4,100.00%,0.00%
시경,4,0,4,100.00%,0.00%
로또,4,0,4,100.00%,0.00%
쉬엄,4,0,4,100.00%,0.00%
자전거,4,0,4,100.00%,0.00%
식대,3,0,3,100.00%,0.00%
공용,0,3,3,0.00%,100.00%
행정,3,0,3,100.00%,0.00%
주머니,3,0,3,100.00%,0.00%
일대,3,0,3,100.00%,0.00%
외동,3,0,3,100.00%,0.00%
센터,3,0,3,100.00%,0.00%
산업,3,0,3,100.00%,0.00%
불국,3,0,3,100.00%,0.00%
본인,3,0,3,100.00%,0.00%
복지,3,0,3,100.00%,0.00%
국동,3,0,3,100.00%,0.00%
경주시,3,0,3,100.00%,0.00%
간식,3,0,3,100.00%,0.00%
시외버스,0,3,3,0.00%,100.00%
딸래미,2,0,2,100.00%,0.00%
수지,0,2,2,0.00%,100.00%
아중,0,2,2,0.00%,100.00%
떡갈비,0,2,2,0.00%,100.00%
레일바이크,0,2,2,0.00%,100.00%
대전,0,1,1,0.00%,100.00%
차선,1,0,1,100.00%,0.00%
정서,1,0,1,100.00%,0.00%
연중무휴,1,0,1,100.00%,0.00%
운행,1,0,1,100.00%,0.00%
전용,1,0,1,100.00%,0.00%
상황,0,1,1,0.00%,100.00%
